%%%%%%%%
%     .%
%...P  %
%.%%%% %
%.%    %
%.% %%%%
%.%    %
%%%%%%%%
